0000000000000000000000000000000000000000000000000000000000000000000000000000000000000000000000000000000000000000000000000000000000000000000000000000000000000000000000000000000000000000000000000000000000000000000000000000
0000000000000000000000000000000000000000000000000000000000000000000000000000000000000000000000000000000000000000000000000000000000000000000000000000000000000000000000000000000000000000000000000000000000000000000000000000
0000000000000000000000000000000000000000000000000000000000000000000000000000000000000000000000000000000000000000000000000000000000000000000000000000000000000000000000000000000000000000000000000000000000000000000000000000
0000000000000000000000000000000000000000000000000000000000000000000000000000000000000000000000000000000000000000000000000000000000000000000000000000000000000000000000000000000000000000000000000000000000000000000000000000
0000000000000000000000000000000000000000000000000000000000000000000000000000000000000000000000000000000000000000000000000000000000000000000000000000000000000000000000000000000000000000000000000000000000000000000000000000
0000000000000000000000000000000000000000000000000000000000000000000000000000000000000000000000000000000000000000000000000000000000000000000000000000000000000000000000000000000000000000000000000000000000000000000000000000
0000000000000000000000000000000000000000000000000000000000000000000000000000000000000000000000000000000000000000000000000000000000000000000000000000000000000000000000000000000000000000000000000000000000000000000000000000
0000000000000000000000000000000000000000000000000000000000000000000000000000000G0G000000000000000000000000000000000000000000000000000000000000000000000000000000000000000000000000000000000000000000000000000000000000000000
000000000000000000000B000000000000000000000000000000000000000000000000000000000AAAAAAAA000AAAB00000000000000000D00000000AAA0000ABBA00000000000000000000000000000000000000000000000000000000990000000000000000000000000000000
000000000000000000000000000000000000000000000000000000000000000000000000000000000000000000000000000000000000000000000000000000000000000000000000000000000000000000000000000000000000000000999000}000000000000000000000000000
0000000000000000000000000000000000000000000000000000000000000000000000000000000000000000000000000000000000000000000000000000000000000000000000000000000000000000000000000000000000000000099990000000000000000000000000000000
000000000000000000000000000000000000000000000000000000000000000000000000000000000000000000000000000000000000000000000000000000000000000000000000000000000000000000000000000000000000000099999000000000:000000000000000000000
000000000000000B000AEABA0000000000000000000006700000000067000000000000000000AEA00000000000000D00000AD0000B00B00B00000A0000000000AA0000009009000000000099009000000000000AABA0000000000009999990000000000000000000000000000000
0000000000000000000000000000000000000670000005800000000058000000000000000000000000000000000000000000000000000000000000000000000000000009900990000000099900990000000000000000000000000099999990000000000000000000000000000000
0000000000000000000000000006700000000580000005800000000058000000000000000000000000000000000000000000000000000000000000000000000000000099900999000000999900999000006700000000000000670999999990000000000000000000000000000000
00~000000000000000000000G00580000000058G00000580000G0G005800000000000000000000000000000000000000G0G0000000H000000G0G0000000G0G0GG00009999009999000099999009999000058000000000G0G00589999999990000000000000000000000000000000
1111111111111111111111111111111111111111111111111111111111111111111100111111111111111000111111111111111111111111111111111111111111111111111111111111111100111111111111111111111111111111111111111111111111111111111111111111
2222222222222222222222222222222222222222222222222222222222222222222200222222222222222000222222222222222222222222222222222222222222222222222222222222222200222222222222222222222222222222222222222222222222222222222222222222