0000000000000000000000000000000000000000000000000000000000000000000000000000000000000000000000000000000000000000000000000000000000000000000000000000000000000000000000000000000000000000000000000000000000000000000000000000
0000000000000000000000000000000000000000000000000000000000000000000000000000000000000000000000000000000000000000000000000000000000000000000000000000000000000000000000000000000000000000000000000000000000000000000000000000
0000000000000000000000000000000000000000000000000000000000000000000000000000000000000000000000000000000000000000000000000000000000000000000000000000000000000000000000000000000000000000000000000000000000000000000000000000
0000000000000000000000000000000000000000000000000000000000000000000000000000000000000000000000000000000000000000000000000000000000000000000000000000000000000000000000000000000000000000000000000000000000000000000000000000
0000000000000000000000000000000000000000000000000000000000000000000000000000000000000000000000000000000000000000000000000000000000000000000000000000000000000000000000000000000000000000000000000000000000000000000000000000
0000000000000000000000000000000000000CC0000000000000000000000000000000000000000000000000000000000000000000000000000000000000000000000000000000000000000000000000000000000000000000000000000000000000000000000000000000000000
00000000000000000000000000000000000000000000G0G00000000000000000000000000000000000000000000000000000000000000000000000000000000000000000000000000000000000000000000000000000000000000000000000000000000000000000000000000000
000000000000000000000000000CCCH000000000=>>>>>?0000000000000CCCC00000000000000000000000000000CC000CC000000000000000000000000000000000000000000000000000000000000000000000000000000000000000000000000000000000000000000000000
000000000000000000000B0000=>>>?0000000000<<<<<00000000000000=>>?0000000000000000G0000CC0000000000000000000000000000000000CC0000000000000000000000000000000000000000000000000000000000000000990000000000000000000000000000000
000000000000000000000000000<<<00000000000<<<<<0000CC000000000<<0000000000000=>>>>?00000000000000000000000000000H000000000000000000AAA0000000000000000000000000000CC00000000000000000000000999000}000000000000000000000000000
000000000000000000000000000<<<00000000000<<<<<000000000000000<<00000000000000<<<<000000000000000000000000=>>>>>>?000000000000000000000000000000000000000000000000AA000000000000000000000099990000000000000000000000000000000
000000000000000000000000000<<<00000=>>>?0<<<<<000000000000000<<00000000000000<<<<00000AAA00000000000000000<<<<<<0000000000000000000000000000000000000000AAAA000000000000000000000000000099999000000000:000000000000000000000
000000000000000000000000=>>>>>>?0000<<<00<<<<<000000000000000<<0000000=>?0000<<<<0000000000AAA000000000000<<<<<<00000=>>?00=>>?0000000000000000000000000000000000000000AABA0000000000009999990000000000000000000000000000000
0000000000000000000000000<<<<<<00000<<<00<<<<<000000000AAA0E0<<00000000<00000<<<<0000000000000000000000000<<<<<<000000<<0000<<0000000000000000ABDA00000000000000000000000000000000000099999990000000000000000000000000000000
0000000000000000000000000<<<<<<00000<<<00<<<<<000000000000000<<00000000<00000<<<<000000000000000000=>>?000<<<<<<000000<<0000<<0000000000000000000000000000000000000000000000000000000999999990000000000000000000000000000000
00~000000000000000=>>?000<<<<<<0=>?0<<<00<<<<<000000000000000<<00000000<00000<<<<0000000000000000000<<0000<<<<<<00CCC0<<0000<<00000000H0000000000000000000000000000000000000000000009999999990000000000000000000000000000000
1111111111111111000<<0000<<<<<<00<00<<<00<<<<<0000=>>?00000=>>>?0=>>>?0<00000<<<<0000000000000000000<<0000<<<<<<00=>?0<<0000<<0000111111111111111111111111111111111111111111111111111111111111111111111111111111111111111111
2222222222222222000<<0000<<<<<<00<00<<<00<<<<<00000<<0000000<<<000<<<00<00000<<<<0000000000000000000<<0000<<<<<<000<00<<0000<<0000222222222222222222222222222222222222222222222222222222222222222222222222222222222222222222