0000000000000000000000000000000000000000000000000000000000000000000000000000000000000000000000000000000000000000000000000000000000000000000000000000000000000000000000000000000000000000000000000000000000000000000000000000
0000000000000000000000000000000000000000000000000000000000000000000000000000000000000000000000000000000000000000000000000000000000000000000000000000000000000000000000000000000000000000000000000000000000000000000000000000
0000000000000000000000000000000000000000000000000000000000000000000000000000000000000000000000000000000000000000000000000000000000000000000000000000000000000000000000000000000000000000000000000000000000000000000000000000
0000000000000000000000000000000000000000000000000000000000000000000000000000000000000000000000000000000000000000000000000000000000000000000000000000000000000000000000000000000000000000000000000000000000000000000000000000
0000000000000000000000000000000000000000000000000000000000000000000000000000000000000000000000000000000000000000000000000000000000000000000000000000000000000000000000000000000000000000000000000000000000000000000000000000
A00000AAAAAAAAAAAAAAAAAAAAAAAAAAAAAAAAAAAAAAAAAAAAAAAAAAAAAAAAAAAAAAAAAAAAAAAAAAAAAAAAAAADAAAAAAAAAAAAAAAAAAAAAAAAAAAAAAAAAAAAAAAAAAAAAAAAAAAAAAAAAAAAAA0000000000000000000000AAAAAAAAAAAAAAAAAAAAAAAAAAAAAAAAAAAAAAAAAAAAAA
A00000000000000000000000000000000000000000000000000000AA00AAAAAA00AAAA000000AAAA00000000000000000000000000000000000000000000000000000000000000000000000000000000000000000000000000000000000000000000000000000000000000000000
A00000000000000000000000000000000000000000000000000000AA00AAAAAA00AAAA000G00AAAA00000000000000000000000000000000000000000000000000000000000000000000000000000000000000000000000000000000000000000000000000000000000000000000
A00000000000000000000B0000000000000000000CCCC0000000AA00000000AA000A0000AA0000000000CCCCCC0000000000000000000000000000000000000000000000000000000000000000000000000000000000000000000000000990000000000000000000000000000000
A000000000000000000000000000000000000000000000000000AA00000000AA000A0000AA0000000000000000000000000000000000000000000000000000000000000000000000000000000000000000000000000000000000000000999000}000000000000000000000000000
A00000000000000000000000000000000000000A0AAAA0D00000AA00000000AA000A0000AA0000000000AAAAAA0000000000000000000000000000000000000000000000000000000000000000000000000000000000000000000000099990000000000000000000000000000000
A00000000000000000000000000000000000000ACA00ACA00000AA0000CCCCAA000A0D00AD00G0G00000AAAAAA0000000000000000000I0000000000000000000000000000000000000000G00000000000000000000000000000000099999000000000:000000000000000000000
A000000000EBBBB000000009090000000000000AAA00AAA00000AAAA00AAAAAA000AAA00AA00AAAA00000000000000000000000I000006700000000000000000000000009900000000000G9900000000000000000000000000000009999990000000000000000000000000000000
A00000000000000000000909090900090000000000000000000000AA00000000000000000000000000000000000000000000000670000580000I000000AA00000000000999000000000009990000000AAAAAE0000000000000000099999990000000000000000000000000000000
A0000000000000000G090909090900090900000000000000000000AA000000000000000000000000000000000000000000000005800005800006700000AA000000000099990000000000999900000000000000000000000000000999999990000000000000000000000000000000
A000~00000000000G909090909090G09090000000000H0H000000000000H00G0G0000000000000000000000000000000000GG0G5800005800G05800000AA000000000999990000000009999900000000H000000000000G0G00009999999990000000000000000000000000000000
1111111111111111111111111111111111111111111111111111111111111111111111111111111100011111111111111111111111111111111111110011001111111111111111111111111100000001111111100000011111111111111111111111111111111111111111111111
2222222222222222222222222222222222222222222222222222222222222222222222222222222200022222222222222222222222222222222222220022002222222222222222222222222200000002222222200000022222222222222222222222222222222222222222222222